%%%%%%%%%
%P      %
% %%%%%%%
% .     %
%%%%%%%%%
