%%%%%%%%%%%%%%%%%%%%%%%
%P%   %   %   %       %
%                     %
% %   %   %   %       %
%                     %
% %   %   %   %     . %
%%%%%%%%%%%%%%%%%%%%%%%