%%%%%%%%%%%%%%%%%%%%%%%%%%%
%P       %        .       %
%  %     %      %         %
%   %   %      %          %
%    %%%      %           %
%%%%%%%%%%%%%%%%%%%%%%%%%%%