%%%%%%%%%%%%%%%%%%%%%%%%%%%%%%
%                          P %
% %%% % % % % % %%%%% %%%%%%%%
% % % %   % %     %     %   %%
%   % % %%% %%% % % %%%%%% %%%
% %       %     %       %    %
% %%%%%%% %%% % % % %%% % %%%%
%     %       %   % %   %    %
% % % % %% %%%%%% %%% %%%%%% %
%                            %
% %%%%% %%%%%%%%%%%%%%%%%%%%%%
%     %   %   %     %   %  . %
% %%%%%%% %   %%% %%% % %%% %%
% %     %   %   %     %   %  %
% % % %%% %%% % % %%% % %%% %%
%       %     % %     % %    %
% %%%%%%%%%%%%% % %% %%  % %%%
%             %   %  %   %   %
% % %%% %%% %%%%%%%%%%% %%% %%
%                            %
%%%%%%%%%%%%%%%%%%%%%%%%%%%%%%
