%%%%%%%%%%%%%%%%%%%%%%%%%%%%%
%P        %        %       .%
% %%%%%%% %%%%%%% %% %%%%%%%%
%     %           %         %
%%% %%%%%%%%%%%%% %%%%%%%%% %
%   %         %     %       %
% %%% %%%%% %%% %%%%% %%%%%%%
%     %     %           %   %
%%%%%%%%%%%%%%%%%%%%%%%%%%%%%