%%%%%%%%%%%%%%%%%%%%%%%%%%%%
%P                         %
%   %%%%%%%%%%%            %
%              %%%%%%%%%   %
%                          %
%                        . %
%%%%%%%%%%%%%%%%%%%%%%%%%%%%