%%%%%%%%%%%
%P     % .%
%%% %%%  %%
%        %%
% %%%%%% %%
%        %%
%%%%%%%%%%%